AFGHANISTAN 	AF 	AFG 	APNIC
AMERICAN SAMOA 	AS 	ASM 	APNIC
AUSTRALIA 	AU 	AUS 	APNIC
BANGLADESH 	BD 	BGD 	APNIC
BHUTAN 	BT 	BTN 	APNIC
BRITISH INDIAN OCEAN TERRITORY 	IO 	IOT 	APNIC
BRUNEI DARUSSALAM 	BN 	BRN 	APNIC
CAMBODIA 	KH 	KHM 	APNIC
CHINA 	CN 	CHN 	APNIC
CHRISTMAS ISLAND 	CX 	CXR 	APNIC
COCOS (KEELING) ISLANDS 	CC 	CCK 	APNIC
COOK ISLANDS 	CK 	COK 	APNIC
EAST TIMOR 	TL 	TLS 	APNIC
FIJI 	FJ 	FJI 	APNIC
FRENCH POLYNESIA 	PF 	PYF 	APNIC
FRENCH SOUTHERN TERRITORIES 	TF 	ATF 	APNIC
GUAM 	GU 	GUM 	APNIC
HONG KONG 	HK 	HKG 	APNIC
INDIA 	IN 	IND 	APNIC
INDONESIA 	ID 	IDN 	APNIC
JAPAN 	JP 	JPN 	APNIC
KIRIBATI 	KI 	KIR 	APNIC
NORTH KOREA 	KP 	PRK 	APNIC
SOUTH KOREA 	KR 	KOR 	APNIC
LAOS 	LA 	LAO 	APNIC
MACAU 	MO 	MAC 	APNIC
MALAYSIA 	MY 	MYS 	APNIC
MALDIVES 	MV 	MDV 	APNIC
MARSHALL ISLANDS 	MH 	MHL 	APNIC
MICRONESIA 	FM 	FSM 	APNIC
MONGOLIA 	MN 	MNG 	APNIC
MYANMAR 	MM 	MMR 	APNIC
NAURU 	NR 	NRU 	APNIC
NEPAL 	NP 	NPL 	APNIC
NEW CALEDONIA 	NC 	NCL 	APNIC
NEW ZEALAND 	NZ 	NZL 	APNIC
NIUE 	NU 	NIU 	APNIC
NORFOLK ISLAND 	NF 	NFK 	APNIC
NORTHERN MARIANA ISLANDS 	MP 	MNP 	APNIC
PAKISTAN 	PK 	PAK 	APNIC
PALAU 	PW 	PLW 	APNIC
PAPUA NEW GUINEA 	PG 	PNG 	APNIC
PHILIPPINES 	PH 	PHL 	APNIC
PITCAIRN 	PN 	PCN 	APNIC
SAMOA 	WS 	WSM 	APNIC
SINGAPORE 	SG 	SGP 	APNIC
SOLOMON ISLANDS 	SB 	SLB 	APNIC
SRI LANKA 	LK 	LKA 	APNIC
TAIWAN 	TW 	TWN 	APNIC
THAILAND 	TH 	THA 	APNIC
TOKELAU 	TK 	TKL 	APNIC
TONGA 	TO 	TON 	APNIC
TUVALU 	TV 	TUV 	APNIC
VANUATU 	VU 	VUT 	APNIC
VIETNAM 	VN 	VNM 	APNIC
WALLIS AND FUTUNA ISLANDS 	WF 	WLF 	APNIC
